16 16
8 8
4 4 4 4 4 4 4 2 2 2 4 4 4 4 4 4
4 3 3 3 3 3 3 3 3 3 3 3 3 3 3 4
4 3 0 0 0 0 0 0 5 0 0 0 5 0 3 4
4 3 0 0 5 0 0 0 0 0 0 0 0 0 3 4
4 3 0 0 5 0 0 5 0 0 0 5 5 0 3 4
4 3 0 0 0 0 0 5 0 0 0 0 0 0 3 4
4 3 0 0 0 0 0 0 0 0 0 0 0 0 3 4
2 3 0 0 0 0 0 0 0 0 0 0 0 0 3 1
2 3 0 5 0 5 0 0 0 0 0 0 0 0 3 2
2 3 0 5 5 5 0 0 5 0 0 0 0 0 3 2
4 3 0 0 0 0 0 0 0 5 0 0 0 0 3 4
4 3 0 0 0 0 0 0 0 5 0 0 0 0 3 4
4 3 0 0 0 0 0 0 0 0 0 0 0 0 3 4
4 3 0 0 5 0 0 0 0 5 0 5 0 0 3 4
4 3 3 3 3 3 3 3 3 3 3 3 3 3 3 4
4 4 4 4 4 4 4 2 2 2 4 4 4 4 4 4
